NO ./assets/eagle.png
SO ./assets/redbrick.png
WE ./assets/mossy.png
EA ./assets/eagle.png

F 96,96,96
C 204,255,255

        1111111111111111111111111 111
        1000000000110000000000001 101
        1011000001110000000000001 101
        1001000000000000000000001 101
111111111011000001110000000000001 101
100000000011000001110111111111111 101
11110111111111011100000010001     111
11110111111111011101010010001
11000S00110101011100000010001
10000000000000001100000010001
10000000000000001101010010001
1100000111010101111101111000111
11110111 1110101 101111010001
11111111 1111111 111111111111